10
*
10
*
1
*
00-1-1
#
01-1-3
#
02-1-2
#
03-1-4
#
04-1-0
#
05-1-12
#
06-1-5
#
07-1-9
#
08-1-7
*
0000000000
0000000000
0000000000
0000000000
0000000000
0000000000
0000000000
0000000000
0000000000
0000000000
*
00 00 00 00 00 00 00 00 06 00
00 00 00 00 00 00 00 00 06 00
00 00 00 00 00 00 00 00 06 00
00 00 00 00 00 00 00 00 06 00
06 06 06 06 00 00 00 00 06 00
00 00 00 06 00 00 00 00 06 00
00 00 00 06 00 00 00 00 06 00
00 00 00 06 00 00 00 00 06 00
00 00 00 06 06 06 06 06 06 06
00 00 00 06 00 00 00 00 00 00
*
6,2:1-1/2-1/3-1/4-1/5-1
#
7,8:3-1/4-6/5-1
#
1,5:0-4/1-2
#
1,3:20-1
*
2,2:1
#
3,1:1